1111111111111111111111111111111111111111
1E00100000000000000000000000000C000000P1
10001010000000000C0000000000000000000001
1000101100000000000001000000000C00000001
10C010C100000000000001000000000000000001
1000111100000000000001111111110000000001
1000000000000000000001000000000000000001
1000000001111110000001000000000C00000001
1000000001C000100000011000C0000000000001
1000000001000010000000111111111111111111
100C000001000011111100000000000000000C01
1000000001000000000000000000000000000001
1111111111111111111111111111111111111111

