11111111111
1P000000001
100C0000001
10000000001
100000C0001
10000000001
100C00000E1
11111111111